1111111111111111111111111111111
1C00000000000000E00000000000001
1000000000000000000000110000001
1000001111111100000000010000001
1111100000000100000000010000001
1000101P1000010000000001000C001
1000101110C00100000000010000001
1000000C1000000C00000001000C001
1000000000000000000000010000001
100000000000000000000001000C001
1C00000000000000000000010000001
1111000000000000000000010000001
1000001111111111000000010000001
1000000000000000000000000000001
10001C1001001001000000000000001
10001110010111010000000C0000001
1000001C01001001000000000000001
1111111111111111111111111111111
