111111111111111111
100000000000000001
111100000000000001
100000111111110001
100000000000010E01
1000101P1000010001
100010111000010001
100000001000000001
111111111111111111
