111111111111111111
1C00000000000000E1
1000U0000000000001
100000111111111111
100000000000010001
1110101P1000010001
1000101110C0010001
1000000C1000000C01
111111111111111111
