1111111111111111111111111111111111111111111111111111111111111111111111
1C00000000000000E000000000000000000000000000000000000C00000000001C0001
1111000000000000000000110000001000000000000000000000000000000000100001
1000001111111100000000010000001000000000000000010000000001000000100001
1000000000000100000000010000001000000000000000010000000001000000100001
1000101P10000100000000010000000000000C00000000010000000001000000100001
1000101110C00100000000010000000000000000000000010000000001000000100001
1000000C1000000C000000010000000000000000000000010000000001000000100001
10000000000000000000000100000000000000000000000100000000000000001000C1
1000000000000000000000010000001000000000000000010000000000000000100001
1C00000000000000000000010000001000000000000000000000000000000000100001
1111000000000000000000010000001000000000000000000000000001000000100001
1000001111111100000000010000001000000000000000000000000001000000100001
1000000000000100000000000000001000000000000000000000000001000000100001
1000101010000100000000000000001000000000000000000000000001000000100001
1000101110C001000000000000000010000000000000C0000000000001000000000001
1000000C1000000C000000000000001000000000000000000000000001000000000001
1111111111111111111111111111111111111111111111111111111111111111111111
