1111111111111111111111111
10010110110C00001000C0101
10101C10000C000010100C0C1
10000P00000111CC00010E011
10C110101110001C101001001
10C001000C0100C1010C00101
1110001010100001001101CC1
100C1100110110011C0010111
100C101011000C110000C1001
1000001001100010010000101
1001000100C1C01C100010011
10CC000C01010C00001100011
11011000100000000010100C1
101100001000C01CC10110001
1111111111111111111111111
