11111111111111111111111111111111111111111111111111111
11E100CC01000000C11010001C01101CC10100001C000C01100C1
10000010010010100000101000001C0C001000C11010000001001
1101000000C100111000000C00101000111001C11000101110101
100101CC00010100001000100010001011C000000100100000001
101CCC0C0011101C0010001000000001011101100100000000001
110C000000001100C00000011100100101000C000000001C00001
101000C0011000000000C000C0100001101001000100C01101011
1P0001110000000101000001010101000000011C10C0000110011
100000000011101001010100001110100100000C0100000C01001
11101000C0C00111010000000000011C01C0000111011000C10C1
1C010011CC11001000100C001001000010CC00000010C11001101
10C001100C1001111C0000011100101000000010C0C1010101001
100010010001000100000C01C110CCCC00011C10C01100C000011
10000011110100100C001101000010001000C00CC000001101011
1010010000110000100C1C011100110CC10101C01100C00001001
10011010000C01111CC01000011C0001101001C011100001101C1
101100100010010111010101000100001011C10001101000C0111
1010000000100000010000101100C1100100C0C00110101C00011
1010000011001C01110C1110C0011000000C00000100001100101
1C1C0100100000C1000101010000000C0100000C001000C0000C1
110000101C0010100100C10100111C01001001000011100100C01
10000001100C000000010101100011100010C00010C00000C0C11
1010110100000011100101000C0010101100000100E1101101001
11100C110CC001010C00001010001001100C01C0CC100011100C1
100C100C00C0100C100001000011C010100001C110010C0C10011
1001000000001000011C000000C10010010000100CC0100000C01
1C1100C10C0000010000111000000C00100010000011001001011
11111111111111111111111111111111111111111111111111111
