11111111111111111111
100C0C10000000C01011
100C0000100C11100001
10P1011001100111C011
10110100010000010001
10001111001100111011
1001010CC011C0000001
1100C0C101011000E001
100001110011C0000001
11111111111111111111
