11111111111111111
10011001010000001
10E0101101010PC01
11C0001C00001C011
10001001000000001
100100C0111010001
10C000CC100010001
10C000000010111C1
11111111111111111
