1111111111111111111111111111111111111111111111111111111111111111111111111111111111111111111111111111
10101111100001C10000C1CC001C10001001C010001000011100100101001110100011110001010001100000101101C00101
100011111C00000000000100011110000C01000101000C1C10000C0C0001C00001101110111010C0000001C001C000000001
100010C0110011111111000011000C0011010111C0001110010CC101C11000010000000101C0011010C0C01000000E101001
10010010000100110C10110C0000010000C0C1C1C0CC01100000000000000000010000000000000010001000010000101101
100110C1010100100100001C0C110011000C10010010110C00000010P01010001011000110100010001C1101101001011C01
111111C100010C100101001C1010100CC0C0001C100001C00001000100110100010011100100000000001C0000C000001011
10C111111C1100101C01010101100001C010100101101011101C001000C000C11010C010000C001100100100101101110001
100000C0000001C0CC1100000C101001000C1000110C1000000101000001000100C00C0C1111C01000000010010010100101
1111111111111111111111111111111111111111111111111111111111111111111111111111111111111111111111111111
