11111111111111111111
1E0011EP0C00001E0111
1101C1C1EC001E110C11
10CC000C1EEEE01011C1
11111111111111111111
