11111111111111111
111CCCCC1CCCCC111
11CP11CCC1CC1C111
11C1C1CC1CC1CCC11
1CCCCC1C1CC1CCCE1
1111CCC1CCC1CC111
1CCCCCCCC1CCCCCC1
1CC1C1CC1CCC11CC1
1CCC11C1111CC1C11
11111111111111111
